32 8 17 2 13 6
9 12 13 11 10 10 12 9 8 8 10 8 12 9 10 8 8 8 10 8 8 10 8 8 8 12 11 10 10 8 8 12 
5 5 3 12 9 12 3 6 5 3 12 5 3 6 9 6 5 5 9 6 3 12 5 5 7 3 10 10 10 6 5 7 
5 3 12 3 6 5 11 12 5 13 5 7 9 12 5 9 6 5 5 11 12 5 5 3 10 12 9 10 10 12 3 12 
5 13 5 9 12 3 12 1 6 5 3 10 6 5 5 5 11 6 3 10 6 5 3 10 12 3 4 9 14 3 12 5 
5 5 5 5 3 14 5 3 12 1 12 9 14 5 5 3 12 9 12 9 12 3 12 13 3 12 5 3 10 10 6 5 
5 3 6 3 8 8 6 13 5 5 5 3 10 6 3 12 3 6 5 5 3 14 5 3 10 6 5 9 10 12 9 6 
5 9 10 12 5 3 14 3 6 5 3 10 10 10 10 6 11 12 5 3 10 10 6 11 10 10 6 5 13 5 5 13 
3 6 11 6 3 10 10 10 14 3 10 10 10 10 10 10 10 6 3 10 10 10 10 10 10 10 10 6 3 6 3 6 
